######## #########
#......###.......#############
#..S...|.|...R...|...S.......#
#......###.......###########.#
######## ####|####         #.#################
            #R#            #.|....R..........#
            #.#            #.###############.#
            #.#            #.#             #.# 
            #.#            #.#             #.########
            #.#            #.#             #..S.....#
            #.#            #.#             #.########
            #.#            #.#             #.#
#############|##############|###############|#############
#........SSSSSSSSSSSSSSSSSSSSSSSSSSSSSSSSSSSSSSSSSSSSSSSS#
#......................................................R.#
#........................................................#
#................SS........R.............................#
#..................RRRRRRRRRRRRRRRRRRRRRRRRRRRRRRR.......#
#.@.........................S............................#
#................S.......................................#
#.............................R.......................S..#
#........................................................#
#........................................................#
#........................................................#
##########################################################