################
#..............#
#..............#
#.......u......#
################