######## #########
#......###.......#############
#..P...|.|.......|...........#
#......###.......###########.#
######## ####|####         #.#################
            #.#            #.|...............#
            #.#            #.###############.#
            #.#            #.#             #.# 
            #.#            #.#             #.#
            #.#            #.#             #.#
            #.#            #.#             #.#
            #.#            #.#             #.#
#############|##############|###############|#############
#........................................................#
#........................................................#
#........................................................#
#........................................................#
#........................................................#
#........................................................#
#........................................................#
#........................................................#
#........................................................#
#........................................................#
#........................................................#
##########################################################