################ ############
#..............###h###......#
#..............|.....|..ss..#
#.......u......#############
################