######## #########
#......###.......#
#......|.|.......#
#......###.......#
######## #########