######## #########
#......###.......#
#..P...|.|.......#
#......###.......#
######## ####|####
            #.#            
            #.#            
            #.#            
            #.#            
            #.#            
            #.#            
            #.#            
#############.############################################
#........................................................#
#........................................................#
#........................................................#
#........................................................#
#........................................................#
#........................................................#
#........................................................#
#........................................................#
#........................................................#
#........................................................#
#........................................................#
##########################################################