######## #########
#......###.......#############
#......|.|.......|...........#
#......###.......###########.#
######## ####|####         #.#################
            #R#            #.|...............#
            #.#            #.###############.#
            #.#            #.#             #.# 
            #.#            #.#             #.########
            #.#            #.#             #........#
            #.#            #.#             #.########
            #.#            #.#             #.#
#############|##############|###############|#############
#........................................................#
#........................................................#
#........................S.......S.......................#
#.........h..............................................#
#........................................................#
#.@...........d.............R............................#
#........................................................#
#........................................................#
#..................s.....................................#
#........................................................#
#........................................................#
##########################################################